1111111111111111111111111111111111
1E0000000000000C00000C000000000001
1P0000001C00C0000000000000000000C1
1111111111111111111111111111111111